date,suspeitos,confirmados,descartados,total, mortes
2020/03/16,37,0,9,46,0
2020/03/17,37,0,9,46,0
2020/03/18,43,0,19,62,0
2020/03/19,65,0,38,103,0
2020/03/20,101,4,56,161,0
2020/03/21,129,4,62,195,0
2020/03/22,117,6,92,215,0
2020/03/23,148,6,115,269,0
2020/03/24,160,8,134,302,0
2020/03/25,167,8,173,348,0